********************
*                  *
*                  *                  
*         +        *
*                  *
*                  *
*                  *
*                  *
*                  *
*                  *
*                  *
********************
